legend: 
$: paved road 
C: car 
!: grass 

! £ £ ! ! 
! £ £ ! ! 
! £ ! ! ! 
£ £ ! £ ! 
! £ £ ! ! 
! £ £ £ ! 
£ £ £ £ £ 
£ £ ! £ ! 
£ £ ! £ £ 
£ £ £ £ ! 
£ £ £ ! £ 
! ! £ ! £ 
! ! £ ! £ 
! £ £ ! £ 
£ £ ! ! £ 
